1111111111111
10000000C00P1
10C0011111001
10010001C0001
1001000010001
1101101010101
1C011E00001C1
1111111111111