1111111111111
10000000C0001
1001011111001
10010000C0001
1001000000001
100011111E111
1P011000000C1
1111111111111